{
	"map_width": 10,
	"map_length": 10,
	"url_block": "res/block.png",
	"url_iron": "res/iron.png",
	"url_muban": "res/muban.png",
	"url_cube": "res/ice.png",
	"map": [
            [1, 1, 1, 0, 0, 1, 1, 1, 0, 0],
            [1, 1, 1, 0, 0, 1, 1, 1, 1, 1],
            [1, 1, 1, 0, 0, 1, 1, 0, 0, 1],
            [1, 1, 1, 2, 1, 1, 1, 0, 0, 1],
            [1, 1, 1, 1, 1, 1, 1, 1, 1, 1],
            [1, 1, 1, 2, 1, 1, 1, 1, 1, 1],
            [1, 1, 1, 1, 1, 1, 3, 1, 1, 1],
            [1, 1, 1, 1, 1, 1, 1, 3, 1, 0],
            [0, 0, 1, 1, 1, 1, 0, 0, 0, 0],
            [0, 0, 0, 1, 1, 1, 0, 0, 0, 0]
	],
	"startpos": [3,3],
	"endpos": [8,6],
	"triggers": []
}